NO             oui.xpm




WE                              oui.xpm
EA               oui.xpm
SO           oui.xpm

F           1          ,    2           ,         3           
C               1             ,2             ,3

11111
10001
11111