NO oui.xpm



WE                              oui.xpm
EA               oui.xpm
SO           oui.xpm

F           30          ,    100           ,         30     
C               30            ,30             ,100

11111111111111111111111111111111111111111111
10000000000000000000000000000000000000000001
10000000000001110000000000000000000000000001
10000000000000000000000000000000000000000001
1E000000000000000000000000000000000000000001
10110000000000000000000000000000000000000001
10001000000000000000000000000000000000000001
10000100000000000000000000000000000000000001
10000000000000000000000000000000000000000001
10000000000000000000000000000000000000000001
10000000000000000000000000000000000000000001
10000000000000000000000000000000000000000001
10000000000000000000000000000000000000000001
10000000000000000000000000000000000000000001
10000000000000000000000000000000000000000001
10000000000000000000000000000000000000000001
10000000000000000000000000000000000000000001
10000000000000000000000000000000000000000001
10000000000000000000000000000000000000000001
10000000000000000000000000000000000000000001
10000000000000000000000000000000000000000001
11111111111111111111111111111111111111111111
