NO ./tests/cub3D/wall/test/north.xpm
SO ./tests/cub3D/wall/test/south.xpm
WE ./tests/cub3D/wall/test/west.xpm
EA ./tests/cub3D/wall/test/east.xpm

F 20,20,20
C 200,200,200

1111111
1000001
1000001
1000001
1000001
1000111
10001
10001
10001S1
1000001
1000001
1000001
1000001
1111111
