NO ./textures/wall.xpm
WE ./textures/wall.xpm
EA ./textures/wall.xpm
SO ./textures/wall.xpm

F 1,2,3
C 40,2,3

1111111111111111111111111111111111111111111111111111111
1000010000000010000000000000000001000000000000001000001
10E00D0000000000000000000000000000000000000000000001001
10000111111111111111111111111111111111111111111D1111111
1111110000000000000000000000010000000000000000000000001
1000001000000000000000000100000000000000000000000000001
1000000000000001000000000000010000000000000000000000001
1000100000001000000000000000000000000000000000000000001
100000000010000000000000000100000000000000011111D111111
1000000000000001000000000000000000000001111000000000001
1000001100000000000000000000000000000010010000100000001
1000000100000000001010000100000000000100000000000001011
1000000001000000000001000000000000001000001001000010001
1000000000000000000000100000000000001000000000000000001
1111111111111111111111111111111111111111111111111111111
